NO ./textures/Nord.xpm
SO ./textures/Sud.xpm
WE ./textures/Ouest.xpm
EA ./textures/Est.xpm
F 117,117,117
C 0,28,255
111111111111111111111111111111111111111111111111111111111111111111111111111111111111111111111111111
100000000000000000000000000000000000000000000000000000000000000000000000000000000000000000000000001
100000000000000000000000000000000000000000000000000000000000000000000000000000000000000000000000001
100000000000000000000000000000000000000000000000000000000000000000000000000000000000000000000000001
100000000000000000000000000000000000000000000000000000000000000000000000000000000000000000000000001
100000000000000000000000000000000000000000000000000000000000000000000000000000000000000000000000001
100000000000000000000000000000000000000000000000000000000000000000000000000000000000000000000000001
100000000000000000000000000000000000000000000000000000000000000000000000000000000000000000000000001
100000000000000000000000000000000000000000000000000000000001000000000000000000000000000000000000001
1000000000000000000000000000000000000000000N0000000000000000000000000000000000000000000000000000001
100000000000000000000000000000000000000000000000000000000001000000000000000000000000000000000000001
100000000000000000000000000000000000000000000000000000000000000000000000000000000000000000000000001
100000000000000000000000000000000000000000000000000000000001000000000000000000000000000000000000001
100000000000000000000000000011111000000000000000000000000000000000000000000000000000000000000000001
100000000000000000000000000000000000000000000000000000000001000000000000000000000000000000000000001
100000000000000000000000000000000000000000000000000000000000000000000000000000000000000000000000001
100000000000000000000000000000000000000000000000000000000000000000000000000000000000000000000000001
100000000000000000000000000000000000000000000000000000000000000000000000000000000000000000000000001
111111111111111111111111111111111111111111111111111111111111111111111111111111111111111111111111111
