NO ./textures/jlarue.xpm
SO ./textures/jlarue.xpm
WE ./textures/jlarue.xpm
EA ./textures/jlarue.xpm
F 117,117,117
C 0,28,255
111111111111111111111111111111111
100000100000100000000010000100001
100100100100111110010010010001001
100100100100100010010010011111001
100100100100101010010010001111001
1001000001000010S0010000000001001
100000000000000000000000000000001
111111111111111111111111111111111
