NO ./textures/uwu.xpm
SO ./textures/pepper.xpm
WE ./textures/jlarue.xpm
EA ./textures/mur1.xpm
DO ./textures/door.xpm
F 106,78,187
C 187,78,106

11111111111
10000S00001
10000000001
11111211111
10000000001
11111111111
