NO ./textures/mur1.xpm
SO ./textures/mur2.xpm
WE ./textures/mur3.xpm
EA ./textures/jlarue.xpm
F 117,117,117
C 0,28,255
111111111111111111111111111111111
100000000000000000000000000000001
100000000000000000000000000000001
100000000000000010000000000000001
100000000000000000000000000000001
1000000000000000000000000000000N1
100000000000000000000000000000001
111111111111111111111111111111111
