NO ./textures/Nord.xpm
SO ./textures/Sud.xpm
WE ./textures/Ouest.xpm
EA ./textures/Est.xpm
F 117,117,117
C 0,28,255
11111
10S01
100011111111
100000000001
111111100001
100000000001111111111111
100000000000000000000001
111111111111111111111001
100000000000000000000011
100111111111111111111111
100000000000000000000001
111111111111111111111111