NO ./textures/brick1.xpm
SO ./textures/brick2.xpm
WE ./textures/brick3.xpm
EA ./textures/brick4.xpm
DO ./textures/door0.xpm
D1 ./textures/door1.xpm
D2 ./textures/door2.xpm
D3 ./textures/door3.xpm
F 175,175,100
C 0,28,255
1111111111111111111111111111111111111111111111111111111111111111111111
1111111111112222222111222212211222111111112111112112111111111111111111
1111111111112112112111211212121211111111112111112222111111111111111111
1111111111112112112111211212121222111111112222211112111111111111111111
1111111111112112112111222212121211111111112111211112111111111111111111
1111111111112112112111211212211222111111112222211112111111111111111111
1111111111110000000000000000202000000000000000001111111111111111111111
1S10001111110111111111111110101111111111111111101111111111111111111111
1212121111110100000000000110100000000000000000101111111222222221111111
1000100000010111111111111110111111111111111111101111111211111121111111
1121111111210000000000000110000000000000000000101111111211111121111111
1121111111210000000000000110000000000000000000101111111222222221111111
1000200000011111111111110111111111111111111100101111111211111121111111
1000111111102000020100010110000000000000000000101111111211111121111111
1000111111101000010100010110000000000000000000101111111211111121111111
1211111111121111112112110110011111111111111111101111111111111111111111
1010000000001222210000110110011111111111111111101111111111121111111111
1212111111111112111211110110010000000000000000001111111111121111111111
1000111111100000000000010110010111111111111111111111111122222221111111
1111111111121111111111110110010000000000000000001111111111121111111111
1111111111101111111111110110011111111111111111101111111111121111111111
1111111111100000000000000110010000000000000000001111111111121111111111
1111111111100000000000000110020000000000000000001111122222221111111111
1111111111111111111111111111111111111111111111111111111111111111111111
