NO ./textures/Nord.xpm
SO ./textures/Sud.xpm
WE ./textures/Ouest.xpm
EA ./textures/Est.xpm
F 117,117,117
C 0,28,255
11111
10S01
112111111111
100002000001
112111111121
100010000001111111111111
100020000000020000200001
111111111111111111111211
100000000000000000000011
111211111111111211111111
100000000000000000000001
111111111111111111111111